MMWR_WEEKSTARTDATE,MMWR_WEEK,MMWR_YEAR,INF_A,INF_B,INF_ALL
2018-08-26,35,2018,16,2,18
2022-04-24,17,2022,6235,43,6278
2005-11-20,47,2005,35,3,38
2018-04-08,15,2018,205,391,596
2020-11-01,45,2020,31,25,56
2022-12-11,50,2022,2827,5,2832
2012-01-08,2,2012,214,15,229
2023-04-16,16,2023,47,63,110
2017-09-24,39,2017,130,13,143
2009-02-15,8,2009,1975,931,2906
2009-04-05,15,2009,270,283,553
2017-08-06,32,2017,76,55,131
2009-10-25,44,2009,9751,19,9770
2013-07-28,31,2013,55,20,75
2023-03-19,12,2023,477,304,781
2015-05-10,19,2015,44,340,384
2006-12-31,1,2007,382,86,468
2018-02-18,8,2018,7177,6400,13577
2013-12-01,49,2013,1655,67,1722
2011-04-03,14,2011,377,252,629
2004-04-11,15,2004,3,12,15
2016-11-20,47,2016,183,17,200
2005-05-08,19,2005,18,18,36
2021-05-02,18,2021,10,15,25
2020-02-23,9,2020,1775,602,2377
2019-03-03,10,2019,13188,434,13622
2023-02-26,9,2023,140,36,176
2014-09-07,37,2014,99,30,129
2023-03-12,11,2023,95,34,129
2014-09-28,40,2014,199,110,309
2020-05-03,19,2020,27,2,29
2019-10-13,42,2019,172,187,359
2021-08-15,33,2021,13,9,22
2011-10-16,42,2011,20,8,28
2015-02-01,5,2015,4899,723,5622
2020-03-08,11,2020,1260,285,1545
2010-04-25,17,2010,29,8,37
2019-04-28,18,2019,229,64,293
2012-05-06,19,2012,348,266,614
2022-04-03,14,2022,6660,34,6694
2014-09-14,38,2014,118,53,171
2007-04-01,14,2007,362,156,518
2019-11-17,47,2019,903,2581,3484
2016-04-10,15,2016,516,398,914
2016-09-18,38,2016,83,16,99
2007-09-16,38,2007,27,3,30
2020-01-26,5,2020,12102,9671,21773
2018-04-29,18,2018,346,724,1070
2014-03-30,14,2014,447,492,939
2016-01-24,4,2016,1035,412,1447
2018-07-15,29,2018,20,9,29
2022-03-27,13,2022,780,2,782
2003-02-02,6,2003,719,580,1299
2019-03-17,12,2019,10322,614,10936
2019-01-13,3,2019,6663,186,6849
2022-03-13,11,2022,4951,52,5003
2018-09-23,39,2018,33,3,36
2022-01-02,1,2022,1158,8,1166
2005-07-31,31,2005,0,0,0
2003-06-15,25,2003,1,0,1
2017-01-08,2,2017,2289,150,2439
2002-03-31,14,2002,61,192,253
2019-05-26,22,2019,212,229,441
2010-01-10,2,2010,384,12,396
2001-09-30,40,2001,5,0,5
2010-03-21,12,2010,237,9,246
2011-06-26,26,2011,3,1,4
2022-04-03,14,2022,711,2,713
2022-10-16,42,2022,5080,108,5188
2017-09-10,37,2017,148,72,220
2011-12-18,51,2011,168,24,192
2006-10-29,44,2006,101,42,143
2017-04-02,14,2017,1443,2986,4429
2010-08-08,32,2010,22,10,32
2017-12-24,52,2017,3292,507,3799
2004-06-13,24,2004,0,2,2
2021-12-19,51,2021,7240,78,7318
2022-10-09,41,2022,2961,88,3049
2010-08-22,34,2010,37,8,45
2008-11-09,46,2008,50,12,62
2009-04-26,18,2009,3502,787,4289
2016-04-17,16,2016,1123,1329,2452
2012-01-15,3,2012,295,17,312
2022-10-30,44,2022,16953,145,17098
2018-07-22,30,2018,16,2,18
2017-08-20,34,2017,62,20,82
2002-09-29,40,2002,2,1,3
2023-04-09,15,2023,267,336,603
2020-09-27,40,2020,3,2,5
2003-11-02,45,2003,859,3,862
2018-05-06,19,2018,36,82,118
2018-03-04,10,2018,580,906,1486
2011-07-17,29,2011,3,5,8
2021-09-12,37,2021,5,4,9
2013-03-31,14,2013,252,641,893
2023-05-21,21,2023,202,236,438
2004-06-06,23,2004,1,2,3
2019-06-02,23,2019,83,52,135
2013-11-24,48,2013,823,40,863
2015-08-02,31,2015,74,17,91
2017-11-19,47,2017,1336,353,1689
2003-05-18,21,2003,1,4,5
2012-07-01,27,2012,34,57,91
2021-06-27,26,2021,1,0,1
2015-01-25,4,2015,6274,606,6880
2020-01-05,2,2020,1458,1388,2846
2021-07-04,27,2021,3,1,4
2012-09-30,40,2012,84,79,163
2015-10-11,41,2015,116,54,170
2008-10-12,42,2008,31,6,37
2007-05-06,19,2007,88,38,126
2016-02-07,6,2016,2265,864,3129
2002-12-15,51,2002,45,152,197
2014-04-27,18,2014,282,415,697
2011-05-22,21,2011,12,4,16
2020-10-04,41,2020,8,6,14
2006-05-14,20,2006,10,41,51
2022-03-20,12,2022,5483,36,5519
2023-04-09,15,2023,62,48,110
2018-11-11,46,2018,668,104,772
2017-10-22,43,2017,340,135,475
2015-05-24,21,2015,42,184,226
2017-07-02,27,2017,39,18,57
2007-06-24,26,2007,11,4,15
2019-12-22,52,2019,5980,11264,17244
2003-09-28,40,2003,21,1,22
2022-10-16,42,2022,596,10,606
2017-11-05,45,2017,689,240,929
2013-10-20,43,2013,183,14,197
2016-10-30,44,2016,137,20,157
2018-12-02,49,2018,1660,152,1812
2010-10-10,41,2010,92,36,128
2017-07-23,30,2017,72,50,122
2003-04-20,17,2003,53,22,75
2004-05-09,19,2004,0,2,2
2017-05-21,21,2017,47,129,176
2017-05-28,22,2017,40,128,168
2007-07-15,29,2007,15,1,16
2021-06-06,23,2021,8,18,26
2005-02-20,8,2005,1657,617,2274
2001-09-23,39,2001,7,1,8
2018-08-12,33,2018,20,3,23
2016-10-16,42,2016,115,97,212
2005-12-04,49,2005,174,8,182
2010-08-15,33,2010,18,3,21
2017-10-08,41,2017,248,98,346
2006-01-08,2,2006,621,13,634
2018-12-09,50,2018,3242,194,3436
2006-01-29,5,2006,770,50,820
2002-09-01,36,2002,0,0,0
2015-07-12,28,2015,49,37,86
2015-08-16,33,2015,80,16,96
2022-05-29,22,2022,574,1,575
2023-05-14,20,2023,168,332,500
2016-06-05,23,2016,70,207,277
2008-07-27,31,2008,3,4,7
2017-10-29,44,2017,288,56,344
2009-08-02,32,2009,1811,3,1814
2021-12-26,52,2021,1522,6,1528
2018-05-13,20,2018,176,236,412
2011-02-27,9,2011,2673,893,3566
2018-10-28,44,2018,390,99,489
2019-08-11,33,2019,57,38,95
2022-07-24,30,2022,46,3,49
2016-11-13,46,2016,200,21,221
2004-11-28,48,2004,104,32,136
2013-09-29,40,2013,159,26,185
2021-11-14,46,2021,531,9,540
2002-12-22,52,2002,73,113,186
2003-11-30,49,2003,3236,32,3268
2010-08-01,31,2010,17,2,19
2004-01-18,3,2004,255,3,258
2002-12-08,50,2002,45,146,191
2021-04-04,14,2021,10,14,24
2022-03-06,10,2022,4206,54,4260
2021-02-28,9,2021,14,17,31
2004-09-26,39,2004,12,2,14
2007-02-18,8,2007,1841,526,2367
2017-08-13,33,2017,62,40,102
2003-01-26,5,2003,707,706,1413
2015-10-18,42,2015,97,52,149
2011-11-13,46,2011,32,11,43
2004-02-08,6,2004,60,5,65
2015-09-06,36,2015,103,28,131
2019-01-27,5,2019,10659,289,10948
2016-01-10,2,2016,571,224,795
2009-10-04,41,2009,8170,19,8189
2003-02-09,7,2003,686,416,1102
2016-05-22,21,2016,139,408,547
2020-05-31,23,2020,9,12,21
2012-08-05,32,2012,147,26,173
2014-04-06,15,2014,421,533,954
2008-09-14,38,2008,10,2,12
2001-01-07,2,2001,727,359,1086
2022-10-23,43,2022,9341,113,9454
2010-03-07,10,2010,461,14,475
2011-03-27,13,2011,598,285,883
2009-09-13,38,2009,4332,5,4337
2003-01-05,2,2003,167,275,442
2010-07-18,29,2010,8,4,12
2020-08-09,33,2020,4,4,8
2014-08-24,35,2014,93,40,133
2001-04-15,16,2001,0,20,20
2021-04-04,14,2021,1,0,1
2020-09-06,37,2020,7,6,13
2005-05-15,20,2005,23,16,39
2018-07-22,30,2018,48,19,67
2021-11-28,48,2021,2395,71,2466
2012-12-09,50,2012,3762,822,4584
2011-09-25,39,2011,21,5,26
2008-01-20,4,2008,1817,338,2155
2021-10-24,43,2021,99,33,132
2017-12-17,51,2017,9237,1698,10935
2018-05-13,20,2018,26,43,69
2022-06-05,23,2022,424,2,426
2018-12-02,49,2018,465,17,482
2017-05-21,21,2017,180,378,558
2021-02-14,7,2021,3,1,4
2018-11-18,47,2018,897,76,973
2020-10-18,43,2020,12,3,15
2008-09-21,39,2008,5,2,7
2020-03-08,11,2020,9077,2690,11767
2016-09-11,37,2016,74,58,132
2018-09-30,40,2018,218,71,289
2022-06-05,23,2022,2451,34,2485
2021-02-21,8,2021,17,25,42
2002-11-10,46,2002,7,16,23
2020-01-26,5,2020,2501,1386,3887
2016-10-02,40,2016,96,10,106
2007-01-28,5,2007,1646,203,1849
2022-09-18,38,2022,775,65,840
2015-09-20,38,2015,82,33,115
2002-01-06,2,2002,922,5,927
2014-05-11,20,2014,202,294,496
2022-01-23,4,2022,1722,46,1768
2022-01-09,2,2022,2600,72,2672
2005-07-03,27,2005,1,4,5
2021-11-07,45,2021,309,36,345
2004-08-22,34,2004,3,1,4
2007-08-26,35,2007,23,7,30
2011-08-07,32,2011,9,2,11
2022-05-08,19,2022,6086,63,6149
2016-07-24,30,2016,40,14,54
2010-11-21,47,2010,322,266,588
2014-09-21,39,2014,136,64,200
2009-11-22,48,2009,1860,7,1867
2022-07-31,31,2022,240,29,269
2022-05-01,18,2022,6702,51,6753
2014-01-05,2,2014,4554,82,4636
2011-10-23,43,2011,31,12,43
2005-07-17,29,2005,1,2,3
2018-09-30,40,2018,48,18,66
2017-09-10,37,2017,117,33,150
2013-07-07,28,2013,66,13,79
2019-02-17,8,2019,13680,475,14155
2004-07-11,28,2004,0,2,2
2022-01-30,5,2022,1570,41,1611
2022-12-18,51,2022,2143,9,2152
2019-02-03,6,2019,3155,46,3201
2005-05-29,22,2005,9,15,24
2016-12-11,50,2016,777,61,838
2005-03-20,12,2005,405,455,860
2012-08-26,35,2012,61,26,87
2009-06-14,25,2009,5914,9,5923
2006-05-07,19,2006,36,64,100
2023-01-15,3,2023,608,16,624
2020-03-29,14,2020,42,12,54
2019-05-12,20,2019,333,268,601
2005-02-13,7,2005,2086,613,2699
2022-05-15,20,2022,5059,27,5086
2012-10-28,44,2012,258,151,409
2014-02-16,8,2014,1153,220,1373
2007-07-08,28,2007,21,2,23
2019-09-08,37,2019,152,180,332
2018-06-03,23,2018,73,80,153
2016-07-10,28,2016,24,31,55
2010-03-28,13,2010,232,5,237
2022-12-25,52,2022,20501,173,20674
2003-12-28,53,2003,1674,12,1686
2010-09-26,39,2010,42,20,62
2022-05-08,19,2022,818,3,821
2017-11-26,48,2017,859,136,995
2002-01-27,5,2002,1620,19,1639
2006-04-09,15,2006,185,208,393
2004-12-05,49,2004,161,32,193
2021-11-21,47,2021,587,6,593
2018-03-25,13,2018,1708,2927,4635
2019-01-27,5,2019,2557,53,2610
2019-12-15,51,2019,1019,1402,2421
2016-06-12,24,2016,59,94,153
2019-01-06,2,2019,5075,218,5293
2004-10-03,40,2004,8,4,12
2017-04-02,14,2017,395,700,1095
2018-04-22,17,2018,110,219,329
2008-04-20,17,2008,59,126,185
2019-10-27,44,2019,196,164,360
2005-09-18,38,2005,0,0,0
2016-08-07,32,2016,22,30,52
2015-11-01,44,2015,31,14,45
2011-04-17,16,2011,114,79,193
2021-11-28,48,2021,973,7,980
2017-07-02,27,2017,75,79,154
2014-06-15,25,2014,115,106,221
2022-07-31,31,2022,58,2,60
2009-06-28,27,2009,3256,7,3263
2009-09-20,39,2009,4592,18,4610
2014-02-09,7,2014,1613,199,1812
2013-10-06,41,2013,193,28,221
2018-09-09,37,2018,43,6,49
2023-04-23,17,2023,211,282,493
2016-01-03,1,2016,396,184,580
2003-01-19,4,2003,471,535,1006
2019-09-01,36,2019,79,31,110
2003-02-16,8,2003,657,383,1040
2004-12-19,51,2004,459,54,513
2012-12-16,51,2012,4833,1096,5929
2006-11-05,45,2006,112,43,155
2009-02-01,6,2009,2109,688,2797
2001-10-07,41,2001,8,0,8
2011-05-01,18,2011,39,23,62
2005-02-06,6,2005,2091,478,2569
2016-12-18,51,2016,2563,341,2904
2017-04-09,15,2017,902,2283,3185
2013-11-10,46,2013,481,39,520
2007-02-25,9,2007,1399,550,1949
2009-09-06,37,2009,3763,11,3774
2005-04-17,16,2005,48,73,121
2021-05-02,18,2021,0,1,1
2018-11-25,48,2018,402,13,415
2021-09-19,38,2021,12,16,28
2005-06-12,24,2005,4,10,14
2016-11-27,48,2016,532,183,715
2018-07-08,28,2018,51,13,64
2007-09-02,36,2007,24,0,24
2018-09-16,38,2018,158,66,224
2013-01-27,5,2013,2963,1076,4039
2020-01-12,3,2020,7712,8020,15732
2017-07-30,31,2017,49,11,60
2007-08-19,34,2007,22,1,23
2005-08-21,34,2005,2,0,2
2019-05-19,21,2019,100,33,133
2017-02-19,8,2017,8763,2952,11715
2003-06-08,24,2003,1,0,1
2022-10-23,43,2022,982,5,987
2001-11-04,45,2001,45,1,46
2004-10-24,43,2004,25,7,32
2001-01-28,5,2001,469,546,1015
2001-03-18,12,2001,26,94,120
2013-07-14,29,2013,42,14,56
2020-09-20,39,2020,13,10,23
2006-12-03,49,2006,202,62,264
2019-11-24,48,2019,1079,2793,3872
2023-04-02,14,2023,95,51,146
2020-12-06,50,2020,14,3,17
2012-04-08,15,2012,964,290,1254
2010-12-12,50,2010,908,530,1438
2007-04-15,16,2007,292,81,373
2011-06-05,23,2011,1,4,5
2014-01-12,3,2014,4133,110,4243
2019-12-29,1,2020,1408,1487,2895
2020-07-05,28,2020,1,1,2
2013-03-10,11,2013,434,1018,1452
2022-07-24,30,2022,268,31,299
2021-03-28,13,2021,13,9,22
2018-03-11,11,2018,2349,3384,5733
2012-02-19,8,2012,1311,75,1386
2019-06-16,25,2019,73,22,95
2011-09-11,37,2011,17,2,19
2022-02-06,6,2022,1855,47,1902
2023-05-14,20,2023,44,68,112
2013-04-28,18,2013,98,195,293
2010-10-03,40,2010,54,23,77
2011-04-24,17,2011,64,61,125
2010-02-21,8,2010,421,3,424
2021-10-10,41,2021,95,10,105
2022-12-04,49,2022,47727,208,47935
2017-03-12,11,2017,948,705,1653
2021-01-17,3,2021,21,62,83
2016-05-08,19,2016,117,160,277
2018-10-21,43,2018,340,101,441
2002-08-25,35,2002,0,0,0
2007-04-22,17,2007,226,68,294
2008-02-24,9,2008,2975,1396,4371
2019-11-24,48,2019,544,651,1195
2020-06-07,24,2020,2,4,6
2020-07-19,30,2020,2,0,2
2012-11-25,48,2012,1541,497,2038
2020-01-12,3,2020,1727,1508,3235
2017-04-30,18,2017,90,203,293
2016-04-24,17,2016,270,291,561
2019-11-03,45,2019,414,1075,1489
2012-03-25,13,2012,1322,239,1561
2020-05-31,23,2020,0,2,2
2003-07-13,29,2003,NA,NA,NA
2008-07-13,29,2008,2,2,4
2009-05-31,23,2009,4971,26,4997
2008-06-01,23,2008,12,5,17
2023-03-26,13,2023,360,353,713
2011-06-12,24,2011,9,0,9
2020-04-19,17,2020,20,8,28
2019-03-10,11,2019,2928,139,3067
2006-12-24,52,2006,581,123,704
2008-11-30,49,2008,106,14,120
2005-11-27,48,2005,83,2,85
2001-10-21,43,2001,13,0,13
2017-06-25,26,2017,94,96,190
2020-09-13,38,2020,14,18,32
2021-04-18,16,2021,12,16,28
2016-02-14,7,2016,1615,591,2206
2015-11-15,46,2015,60,8,68
2022-08-07,32,2022,224,27,251
2005-08-14,33,2005,5,0,5
2007-10-28,44,2007,63,11,74
2018-02-04,6,2018,2616,1373,3989
2003-04-27,18,2003,19,12,31
2012-05-20,21,2012,169,253,422
2021-01-03,1,2021,28,95,123
2011-08-14,33,2011,13,3,16
2017-01-01,1,2017,4288,386,4674
2020-08-30,36,2020,1,0,1
2019-12-29,1,2020,5645,9664,15309
2002-04-07,15,2002,36,226,262
2016-10-09,41,2016,92,16,108
2017-11-26,48,2017,1552,436,1988
2012-01-29,5,2012,617,41,658
2022-09-18,38,2022,137,10,147
2007-08-12,33,2007,19,0,19
2020-04-26,18,2020,24,3,27
2020-01-19,4,2020,9478,8764,18242
2003-10-26,44,2003,538,0,538
2017-07-09,28,2017,92,68,160
2008-10-19,43,2008,46,14,60
2020-06-28,27,2020,1,0,1
2009-11-08,46,2009,5788,9,5797
2016-09-04,36,2016,48,10,58
2009-06-21,26,2009,4245,7,4252
2013-04-14,16,2013,143,311,454
2001-11-18,47,2001,73,1,74
2016-03-20,12,2016,3919,1652,5571
2015-01-18,3,2015,7435,548,7983
2014-05-25,22,2014,188,208,396
2022-05-15,20,2022,776,1,777
2019-08-18,34,2019,94,116,210
2020-02-16,8,2020,1947,742,2689
2005-07-10,28,2005,0,2,2
2023-04-30,18,2023,184,290,474
2020-06-07,24,2020,8,8,16
2017-02-12,7,2017,2702,556,3258
2007-12-09,50,2007,191,27,218
2015-07-26,30,2015,67,10,77
2010-11-07,45,2010,188,164,352
2020-03-15,12,2020,4131,1352,5483
2022-07-17,29,2022,348,38,386
2006-02-05,6,2006,833,96,929
2023-02-05,6,2023,1111,269,1380
2013-12-08,50,2013,1921,47,1968
2020-11-22,48,2020,8,3,11
2020-05-17,21,2020,8,8,16
2006-03-19,12,2006,675,354,1029
2018-01-21,4,2018,3327,1007,4334
2008-11-16,47,2008,59,23,82
2019-07-07,28,2019,53,12,65
2004-11-14,46,2004,70,20,90
2007-06-17,25,2007,6,2,8
2018-10-07,41,2018,223,83,306
2010-05-09,19,2010,23,3,26
2002-02-10,7,2002,1765,68,1833
2019-04-07,15,2019,886,155,1041
2015-11-22,47,2015,41,16,57
2018-07-15,29,2018,57,15,72
2020-02-02,6,2020,2501,1164,3665
2023-05-21,21,2023,35,45,80
2005-12-25,52,2005,636,18,654
2019-06-09,24,2019,85,27,112
2022-02-27,9,2022,612,3,615
2001-12-16,51,2001,219,1,220
2003-11-23,48,2003,2241,10,2251
2021-05-09,19,2021,17,13,30
2019-06-30,27,2019,129,86,215
2002-09-22,39,2002,0,0,0
2006-01-22,4,2006,731,23,754
2020-09-06,37,2020,1,0,1
2018-06-03,23,2018,10,15,25
2003-10-19,43,2003,455,4,459
2012-05-27,22,2012,147,224,371
2011-08-21,34,2011,12,5,17
2022-02-27,9,2022,3612,43,3655
2017-11-12,46,2017,463,95,558
2004-02-15,7,2004,48,8,56
2017-08-13,33,2017,40,10,50
2006-04-23,17,2006,49,117,166
2002-11-17,47,2002,9,6,15
2016-01-24,4,2016,701,229,930
2020-02-16,8,2020,12714,5755,18469
2022-01-23,4,2022,592,7,599
2003-04-13,16,2003,63,11,74
2022-06-26,26,2022,102,1,103
2017-07-09,28,2017,35,25,60
2016-09-25,39,2016,106,83,189
2013-09-01,36,2013,101,12,113
2022-01-16,3,2022,2190,72,2262
2012-03-11,11,2012,2449,197,2646
2004-02-29,9,2004,10,8,18
2009-11-29,49,2009,1314,9,1323
2021-07-25,30,2021,11,12,23
2005-01-30,5,2005,1900,424,2324
2018-10-07,41,2018,71,13,84
2019-04-07,15,2019,3201,559,3760
2001-03-04,10,2001,46,146,192
2006-12-17,51,2006,596,133,729
2007-12-02,49,2007,157,22,179
2013-12-15,51,2013,3623,62,3685
2002-03-03,10,2002,637,166,803
2020-12-27,53,2020,8,3,11
2020-08-02,32,2020,0,0,0
2022-09-11,37,2022,81,5,86
2017-12-24,52,2017,12002,2092,14094
2010-07-04,27,2010,4,0,4
2002-02-24,9,2002,1001,136,1137
2010-06-06,23,2010,5,3,8
2020-04-12,16,2020,19,5,24
2020-07-26,31,2020,0,0,0
2013-06-02,23,2013,51,78,129
2016-07-17,29,2016,21,14,35
2012-06-17,25,2012,67,105,172
2003-10-12,42,2003,253,1,254
2020-07-05,28,2020,6,5,11
2013-06-23,26,2013,38,27,65
2007-07-29,31,2007,22,2,24
2015-06-07,23,2015,49,129,178
2005-01-02,1,2005,1113,166,1279
2020-03-15,12,2020,497,123,620
2017-04-23,17,2017,142,281,423
2009-03-15,12,2009,856,926,1782
2018-01-07,2,2018,3799,739,4538
2017-01-22,4,2017,6254,797,7051
2008-10-05,41,2008,16,6,22
2023-01-15,3,2023,2982,158,3140
2020-05-03,19,2020,14,15,29
2015-11-01,44,2015,97,68,165
2009-08-30,36,2009,2986,4,2990
2005-09-04,36,2005,1,0,1
2023-05-28,22,2023,174,178,352
2016-08-21,34,2016,33,10,43
2015-02-15,7,2015,2360,1009,3369
2016-09-18,38,2016,97,67,164
2012-02-12,7,2012,981,69,1050
2021-06-06,23,2021,2,0,2
2012-09-23,39,2012,40,49,89
2019-03-31,14,2019,1246,186,1432
2018-05-20,21,2018,119,163,282
2021-02-07,6,2021,11,35,46
2021-08-08,32,2021,3,0,3
2021-12-12,50,2021,6681,61,6742
2001-10-14,42,2001,17,0,17
2014-06-29,27,2014,73,80,153
2021-09-19,38,2021,11,0,11
2012-02-26,9,2012,1821,107,1928
2017-10-08,41,2017,165,23,188
2016-05-01,18,2016,427,822,1249
2014-07-13,29,2014,52,42,94
2019-07-28,31,2019,46,13,59
2016-10-23,43,2016,144,12,156
2016-10-30,44,2016,201,118,319
2002-06-16,25,2002,0,4,4
2016-08-14,33,2016,30,11,41
2019-09-15,38,2019,162,253,415
2003-12-14,51,2003,3599,20,3619
2005-09-25,39,2005,0,0,0
2017-07-30,31,2017,96,35,131
2016-07-03,27,2016,20,19,39
2004-05-23,21,2004,3,3,6
2012-11-18,47,2012,1006,362,1368
2017-08-27,35,2017,120,62,182
2021-01-24,4,2021,3,1,4
2009-04-12,16,2009,153,186,339
2021-05-16,20,2021,23,20,43
2013-03-03,10,2013,562,1083,1645
2004-05-16,20,2004,1,3,4
2008-08-10,33,2008,0,1,1
2020-10-11,42,2020,27,26,53
2003-03-02,10,2003,474,192,666
2011-11-20,47,2011,55,20,75
2019-07-07,28,2019,102,81,183
2010-02-28,9,2010,440,5,445
2021-07-18,29,2021,2,0,2
2007-02-11,7,2007,2107,416,2523
2022-11-27,48,2022,48835,172,49007
2018-12-16,51,2018,1442,37,1479
2014-08-03,32,2014,58,21,79
2007-04-29,18,2007,147,56,203
2018-04-08,15,2018,901,1917,2818
2020-12-20,52,2020,2,2,4
2022-11-20,47,2022,2680,3,2683
2017-06-04,23,2017,136,225,361
2005-10-16,42,2005,18,5,23
2012-10-14,42,2012,179,121,300
2015-10-18,42,2015,61,13,74
2016-01-17,3,2016,716,315,1031
2012-11-11,46,2012,586,265,851
2014-11-02,45,2014,1001,155,1156
2018-12-30,1,2019,1649,29,1678
2010-10-17,42,2010,96,45,141
2012-04-15,16,2012,844,313,1157
2020-10-25,44,2020,22,19,41
2017-06-18,25,2017,107,117,224
2020-06-14,25,2020,0,0,0
2023-02-19,8,2023,138,18,156
2022-03-20,12,2022,701,1,702
2023-04-30,18,2023,52,62,114
2022-01-16,3,2022,731,1,732
2019-03-24,13,2019,7664,593,8257
2014-12-28,53,2014,10997,409,11406
2005-11-13,46,2005,36,4,40
2022-08-07,32,2022,92,2,94
2018-03-11,11,2018,490,786,1276
2002-04-21,17,2002,19,149,168
2002-11-03,45,2002,6,4,10
2020-05-17,21,2020,1,0,1
2010-10-24,43,2010,115,53,168
2004-04-18,16,2004,13,11,24
2009-07-05,28,2009,3248,7,3255
2016-06-12,24,2016,25,22,47
2023-02-05,6,2023,270,27,297
2022-07-10,28,2022,438,50,488
2011-11-27,48,2011,56,17,73
2018-09-23,39,2018,169,52,221
2005-06-05,23,2005,4,8,12
2009-05-10,20,2009,2815,134,2949
2015-10-11,41,2015,48,10,58
2012-12-30,1,2013,5377,1097,6474
2018-02-18,8,2018,1398,1252,2650
2021-01-24,4,2021,12,50,62
2018-01-28,5,2018,15193,6915,22108
2021-06-20,25,2021,12,17,29
2013-03-24,13,2013,221,732,953
2019-06-09,24,2019,129,134,263
2003-10-05,41,2003,77,0,77
2017-05-07,19,2017,232,584,816
2004-10-10,41,2004,13,1,14
2020-02-02,6,2020,12960,8787,21747
2018-10-21,43,2018,114,16,130
2020-05-10,20,2020,14,10,24
2020-09-27,40,2020,19,21,40
2012-09-16,38,2012,56,40,96
2009-05-24,22,2009,4092,42,4134
2011-01-02,1,2011,2070,575,2645
2013-01-13,3,2013,4858,1078,5936
2021-05-23,21,2021,0,0,NA
2005-11-06,45,2005,34,6,40
2022-06-19,25,2022,1084,40,1124
2022-05-29,22,2022,3785,46,3831
2010-03-14,11,2010,347,4,351
2021-01-17,3,2021,3,1,4
2023-01-01,1,2023,10268,153,10421
2020-11-01,45,2020,6,7,13
2011-01-09,2,2011,2429,598,3027
2013-02-03,6,2013,2008,1051,3059
2015-11-08,45,2015,122,86,208
2012-07-08,28,2012,56,43,99
2020-03-22,13,2020,759,280,1039
2003-06-29,27,2003,1,0,1
2016-05-08,19,2016,280,662,942
2003-03-23,13,2003,180,44,224
2022-12-11,50,2022,42073,216,42289
2018-08-26,35,2018,98,33,131
2022-06-12,24,2022,1600,42,1642
2018-12-16,51,2018,5288,192,5480
2005-12-18,51,2005,591,9,600
2023-02-12,7,2023,780,261,1041
2010-08-29,35,2010,28,6,34
2021-08-01,31,2021,5,0,5
2019-08-18,34,2019,58,34,92
2015-11-08,45,2015,46,16,62
2002-08-18,34,2002,0,1,1
2004-11-21,47,2004,40,21,61
2001-03-25,13,2001,10,67,77
2009-10-18,43,2009,12081,30,12111
2020-03-29,14,2020,196,122,318
2021-05-09,19,2021,0,0,NA
2013-09-15,38,2013,95,22,117
2001-01-14,3,2001,805,477,1282
2008-07-06,28,2008,2,4,6
2022-01-30,5,2022,508,4,512
2023-01-22,4,2023,330,10,340
2016-07-10,28,2016,23,16,39
2012-06-10,24,2012,124,179,303
2015-03-08,10,2015,870,1654,2524
2016-10-23,43,2016,143,88,231
2016-04-03,14,2016,702,442,1144
2013-06-09,24,2013,64,62,126
2004-02-22,8,2004,26,12,38
2020-04-05,15,2020,31,4,35
2020-12-27,53,2020,34,73,107
2012-08-19,34,2012,84,25,109
2002-05-26,22,2002,1,25,26
2007-02-04,6,2007,2121,411,2532
2016-05-29,22,2016,82,226,308
2021-10-03,40,2021,41,37,78
2004-09-12,37,2004,5,2,7
2017-05-07,19,2017,102,191,293
2007-01-07,2,2007,508,86,594
2006-10-15,42,2006,58,22,80
2002-12-29,1,2003,115,188,303
2017-03-26,13,2017,685,937,1622
2023-03-05,10,2023,602,298,900
2004-03-07,10,2004,8,6,14
2009-12-13,51,2009,655,6,661
2004-10-17,42,2004,27,10,37
2019-10-06,41,2019,146,181,327
2012-09-09,37,2012,30,48,78
2018-06-24,26,2018,8,1,9
2020-06-14,25,2020,12,8,20
2019-03-31,14,2019,4883,588,5471
2004-08-29,35,2004,4,0,4
2011-01-16,3,2011,2987,737,3724
2002-08-04,32,2002,0,0,0
2021-09-05,36,2021,6,1,7
2015-03-01,9,2015,1336,1352,2688
2010-12-19,51,2010,1327,671,1998
2017-03-26,13,2017,2345,3658,6003
2020-11-22,48,2020,19,36,55
2004-03-14,11,2004,11,2,13
2016-09-11,37,2016,65,20,85
2020-08-09,33,2020,0,1,1
2016-04-03,14,2016,1971,1390,3361
2003-04-06,15,2003,108,26,134
2020-08-16,34,2020,0,0,0
2010-01-17,3,2010,444,3,447
2009-07-19,30,2009,2296,3,2299
2019-05-12,20,2019,128,58,186
2008-04-27,18,2008,46,79,125
2022-04-10,15,2022,6844,26,6870
2019-09-15,38,2019,95,51,146
2020-10-04,41,2020,30,28,58
2021-10-31,44,2021,124,37,161
2014-03-02,10,2014,693,281,974
2016-12-18,51,2016,1056,82,1138
2015-11-29,48,2015,66,24,90
2019-02-24,9,2019,13416,436,13852
2021-03-28,13,2021,5,1,6
2017-04-16,16,2017,157,385,542
2011-07-31,31,2011,8,2,10
2015-12-27,52,2015,203,57,260
2008-08-17,34,2008,3,3,6
2002-05-19,21,2002,2,34,36
2002-07-21,30,2002,0,0,0
2013-05-19,21,2013,52,109,161
2019-10-20,43,2019,179,121,300
2022-05-22,21,2022,627,1,628
2004-06-27,26,2004,1,2,3
2015-12-13,50,2015,108,33,141
2011-10-09,41,2011,11,8,19
2007-07-01,27,2007,13,5,18
2017-12-10,50,2017,4560,844,5404
2014-11-23,48,2014,3424,200,3624
2018-07-29,31,2018,43,17,60
2014-06-08,24,2014,151,139,290
2022-08-28,35,2022,87,4,91
2018-01-21,4,2018,16634,5350,21984
2005-04-24,17,2005,24,40,64
2021-08-01,31,2021,14,18,32
2018-02-04,6,2018,14116,7858,21974
2021-08-22,34,2021,13,11,24
2011-12-25,52,2011,158,17,175
2015-06-28,26,2015,96,33,129
2016-03-27,13,2016,1020,546,1566
2007-06-10,24,2007,19,7,26
2015-11-15,46,2015,84,98,182
2016-11-06,45,2016,161,12,173
2012-03-04,10,2012,2166,116,2282
2021-02-28,9,2021,2,0,2
2012-07-22,30,2012,70,31,101
2014-12-07,50,2014,7867,315,8182
2018-10-28,44,2018,110,10,120
2012-09-02,36,2012,51,36,87
2019-11-10,46,2019,353,429,782
2005-12-11,50,2005,325,5,330
2020-07-12,29,2020,11,12,23
2022-04-24,17,2022,798,1,799
2016-12-04,49,2016,496,30,526
2012-04-22,17,2012,582,269,851
2001-12-30,1,2002,534,6,540
2007-11-25,48,2007,111,13,124
2014-01-19,4,2014,3461,152,3613
2018-11-25,48,2018,1001,106,1107
2021-04-11,15,2021,8,13,21
2019-10-06,41,2019,119,79,198
2005-10-23,43,2005,11,2,13
2003-03-30,14,2003,106,17,123
2015-11-22,47,2015,119,92,211
2020-06-21,26,2020,3,0,3
2012-06-24,26,2012,51,117,168
2011-05-29,22,2011,7,5,12
2009-08-23,35,2009,2131,14,2145
2021-10-31,44,2021,194,5,199
2013-04-07,15,2013,174,457,631
2005-08-07,32,2005,4,0,4
2009-03-22,13,2009,607,636,1243
2014-03-16,12,2014,517,402,919
2018-08-05,32,2018,19,3,22
2004-07-25,30,2004,8,0,8
2005-01-09,2,2005,931,182,1113
2021-12-05,49,2021,1193,3,1196
2021-06-13,24,2021,17,12,29
2011-05-08,19,2011,24,14,38
2017-03-05,10,2017,4632,2785,7417
2018-12-23,52,2018,1630,36,1666
2011-09-04,36,2011,11,2,13
2006-02-26,9,2006,1174,263,1437
2009-03-01,10,2009,1494,1158,2652
2007-07-22,30,2007,35,2,37
2006-10-08,41,2006,58,9,67
2014-08-17,34,2014,66,40,106
2021-02-07,6,2021,2,2,4
2005-10-09,41,2005,10,1,11
2021-10-17,42,2021,55,7,62
2022-04-10,15,2022,808,4,812
2002-03-10,11,2002,359,210,569
2021-01-10,2,2021,4,4,8
2020-04-19,17,2020,26,4,30
2016-01-03,1,2016,302,78,380
2010-09-05,36,2010,39,7,46
2017-05-14,20,2017,216,479,695
2001-11-11,46,2001,30,3,33
2002-07-14,29,2002,1,1,2
2016-03-20,12,2016,1275,509,1784
2017-11-19,47,2017,533,75,608
2004-04-25,17,2004,4,7,11
2010-05-30,22,2010,6,2,8
2012-07-29,31,2012,165,35,200
2016-07-31,31,2016,48,5,53
2019-01-13,3,2019,1961,42,2003
2004-12-12,50,2004,230,45,275
2007-11-04,45,2007,74,11,85
2014-04-13,16,2014,351,445,796
2016-11-20,47,2016,451,169,620
2022-12-25,52,2022,1563,7,1570
2020-12-06,50,2020,26,76,102
2023-05-07,19,2023,55,73,128
2010-07-25,30,2010,19,5,24
2007-05-13,20,2007,65,27,92
2020-04-26,18,2020,19,8,27
2022-05-01,18,2022,836,1,837
2022-04-17,16,2022,831,3,834
2007-06-03,23,2007,16,4,20
2016-03-13,11,2016,5047,1790,6837
2015-04-05,14,2015,201,1271,1472
2002-04-14,16,2002,18,138,156
2008-02-10,7,2008,3664,1079,4743
2020-11-15,47,2020,34,54,88
2016-08-07,32,2016,34,16,50
2021-03-14,11,2021,26,19,45
2021-01-31,5,2021,21,53,74
2018-04-01,14,2018,1132,2337,3469
2022-07-10,28,2022,126,1,127
2017-01-22,4,2017,2507,224,2731
2005-03-06,10,2005,794,415,1209
2018-01-28,5,2018,3077,1201,4278
2011-03-13,11,2011,1395,555,1950
2013-08-11,33,2013,48,10,58
2006-01-01,1,2006,481,21,502
2020-07-26,31,2020,3,5,8
2013-02-24,9,2013,730,1046,1776
2014-06-01,23,2014,139,131,270
2007-12-16,51,2007,263,50,313
2015-01-04,1,2015,8866,372,9238
2022-08-28,35,2022,335,35,370
2022-11-20,47,2022,40596,179,40775
2010-09-12,37,2010,50,14,64
2020-08-23,35,2020,7,13,20
2014-05-04,19,2014,234,327,561
2017-12-03,49,2017,1131,150,1281
2021-07-11,28,2021,11,17,28
2015-12-13,50,2015,244,192,436
2011-10-30,44,2011,29,9,38
2019-07-14,29,2019,105,80,185
2018-04-01,14,2018,290,531,821
2017-12-17,51,2017,2750,375,3125
2019-07-14,29,2019,71,11,82
2012-01-22,4,2012,436,30,466
2019-01-20,4,2019,2174,45,2219
2019-05-05,19,2019,153,72,225
2020-04-05,15,2020,75,46,121
2005-09-11,37,2005,4,1,5
2016-02-28,9,2016,5523,1629,7152
2016-07-31,31,2016,33,20,53
2006-11-12,46,2006,101,32,133
2020-05-10,20,2020,24,3,27
2017-12-31,1,2018,13018,2535,15553
2018-09-02,36,2018,119,52,171
2018-06-24,26,2018,57,29,86
2009-01-04,2,2009,490,78,568
2002-10-06,41,2002,0,0,0
2019-02-17,8,2019,3060,97,3157
2020-10-11,42,2020,5,5,10
2016-01-17,3,2016,474,153,627
2017-10-01,40,2017,230,112,342
2020-03-01,10,2020,11050,3378,14428
2021-06-13,24,2021,0,0,NA
2019-10-20,43,2019,201,354,555
2016-12-25,52,2016,4270,388,4658
2018-06-17,25,2018,49,38,87
2021-08-29,35,2021,22,13,35
2003-11-16,47,2003,1966,8,1974
2021-12-19,51,2021,1309,3,1312
2007-10-21,43,2007,45,5,50
2022-01-02,1,2022,3606,68,3674
2005-05-01,18,2005,18,30,48
2017-07-16,29,2017,34,16,50
2020-08-23,35,2020,0,0,0
2019-03-03,10,2019,3191,126,3317
2018-11-04,45,2018,546,98,644
2015-10-04,40,2015,71,11,82
2019-04-21,17,2019,1028,408,1436
2004-09-05,36,2004,0,3,3
2004-11-07,45,2004,38,24,62
2003-03-09,11,2003,440,131,571
2018-10-14,42,2018,87,17,104
2022-02-20,8,2022,2813,33,2846
2005-04-10,15,2005,53,123,176
2010-06-20,25,2010,11,0,11
2016-08-28,35,2016,40,11,51
2021-02-21,8,2021,3,3,6
2022-05-22,21,2022,4756,39,4795
2012-04-29,18,2012,473,247,720
2012-08-12,33,2012,136,28,164
2015-12-20,51,2015,220,166,386
2020-08-16,34,2020,6,8,14
2022-10-02,40,2022,1984,105,2089
2019-08-25,35,2019,142,220,362
2003-01-12,3,2003,282,385,667
2016-05-15,20,2016,116,108,224
2018-11-18,47,2018,279,8,287
2019-08-04,32,2019,79,87,166
2020-11-29,49,2020,31,65,96
2022-06-19,25,2022,197,1,198
2010-09-19,38,2010,46,21,67
2023-01-29,5,2023,263,20,283
2022-02-06,6,2022,635,2,637
2009-03-08,11,2009,1088,1062,2150
2019-09-22,39,2019,96,56,152
2019-06-02,23,2019,144,207,351
2020-08-02,32,2020,7,4,11
2021-09-05,36,2021,11,9,20
2019-05-05,19,2019,404,275,679
2013-08-25,35,2013,110,10,120
2022-07-17,29,2022,52,4,56
2008-06-29,27,2008,1,3,4
2018-03-18,12,2018,364,648,1012
2022-03-06,10,2022,598,1,599
2008-03-16,12,2008,1035,908,1943
2022-11-13,46,2022,2339,6,2345
2017-09-03,36,2017,119,16,135
2022-08-14,33,2022,80,2,82
2015-03-29,13,2015,291,1375,1666
2008-05-25,22,2008,9,10,19
2013-02-17,8,2013,985,1084,2069
2017-01-15,3,2017,2334,199,2533
2016-05-01,18,2016,138,215,353
2015-12-27,52,2015,264,200,464
2014-03-09,11,2014,617,313,930
2008-06-22,26,2008,0,6,6
2007-09-30,40,2007,39,5,44
2011-02-20,8,2011,3396,1203,4599
2023-04-16,16,2023,196,264,460
2008-11-23,48,2008,88,24,112
2020-06-21,26,2020,9,7,16
2018-01-14,3,2018,14782,3905,18687
2015-07-19,29,2015,57,23,80
2004-08-01,31,2004,1,1,2
2017-03-12,11,2017,3795,3171,6966
2020-12-13,51,2020,36,81,117
2017-04-30,18,2017,252,708,960
2009-11-01,45,2009,7551,30,7581
2022-02-20,8,2022,499,2,501
2012-03-18,12,2012,1930,241,2171
2016-03-06,10,2016,2533,741,3274
2001-10-28,44,2001,13,0,13
2014-02-23,9,2014,789,237,1026
2021-12-05,49,2021,3913,51,3964
2001-12-09,50,2001,165,4,169
2009-09-27,40,2009,5721,17,5738
2005-01-16,3,2005,1265,211,1476
2003-06-22,26,2003,0,0,0
2011-09-18,38,2011,13,7,20
2023-01-29,5,2023,1426,200,1626
2014-08-10,33,2014,76,36,112
2019-08-11,33,2019,78,94,172
2018-08-19,34,2018,43,2,45
2006-03-05,10,2006,1193,317,1510
2021-07-18,29,2021,5,13,18
2013-08-18,34,2013,55,3,58
2013-01-20,4,2013,4039,1091,5130
2008-05-18,21,2008,14,15,29
2018-10-14,42,2018,311,89,400
2009-04-19,17,2009,169,113,282
2019-12-01,49,2019,682,866,1548
2013-06-16,25,2013,48,47,95
2015-10-04,40,2015,84,43,127
2002-02-03,6,2002,1779,28,1807
2015-04-12,15,2015,158,969,1127
2019-02-24,9,2019,3244,82,3326
2019-11-10,46,2019,535,1589,2124
2021-03-21,12,2021,1,0,1
2016-04-24,17,2016,701,1143,1844
2006-04-16,16,2006,111,203,314
2002-07-28,31,2002,0,0,0
2016-04-10,15,2016,1506,1364,2870
2016-06-05,23,2016,21,37,58
2018-08-19,34,2018,77,27,104
2015-06-21,25,2015,75,46,121
2018-06-10,24,2018,51,65,116
2021-04-25,17,2021,1,0,1
2013-11-17,47,2013,648,55,703
2016-07-03,27,2016,24,30,54
2006-03-26,13,2006,470,387,857
2011-05-15,20,2011,9,10,19
2002-11-24,48,2002,13,28,41
2013-07-21,30,2013,51,9,60
2016-02-14,7,2016,3135,1092,4227
2011-07-10,28,2011,3,3,6
2015-12-20,51,2015,123,43,166
2015-08-30,35,2015,107,27,134
2008-01-13,3,2008,1126,210,1336
2013-08-04,32,2013,51,12,63
2015-04-26,17,2015,67,543,610
2016-07-24,30,2016,20,25,45
2009-03-29,14,2009,328,471,799
2016-01-31,5,2016,1572,587,2159
2023-04-23,17,2023,62,59,121
2016-06-19,25,2016,44,83,127
2017-10-01,40,2017,139,21,160
2017-09-24,39,2017,155,77,232
2008-09-28,40,2008,11,6,17
2022-12-18,51,2022,31309,143,31452
2021-01-31,5,2021,4,3,7
2019-04-21,17,2019,309,120,429
2016-05-22,21,2016,62,84,146
2008-03-02,10,2008,2179,1366,3545
2017-01-29,5,2017,2677,328,3005
2017-07-16,29,2017,87,45,132
2011-12-11,50,2011,110,19,129
2021-03-21,12,2021,13,17,30
2002-06-02,23,2002,0,7,7
2023-04-02,14,2023,371,361,732
2019-03-10,11,2019,13364,559,13923
2007-08-05,32,2007,30,4,34
2006-11-26,48,2006,155,54,209
2015-05-31,22,2015,42,151,193
2009-01-18,4,2009,1065,189,1254
2019-09-01,36,2019,136,230,366
2021-08-08,32,2021,8,11,19
2019-03-17,12,2019,2174,144,2318
2023-02-26,9,2023,606,224,830
2001-02-25,9,2001,75,181,256
2013-09-08,37,2013,115,7,122
2021-07-04,27,2021,5,9,14
2021-07-25,30,2021,3,0,3
2017-04-09,15,2017,227,530,757
2011-10-02,40,2011,24,9,33
2019-05-26,22,2019,82,56,138
2011-03-06,10,2011,1979,688,2667
2021-03-07,10,2021,2,2,4
2009-07-12,29,2009,2637,4,2641
2017-05-14,20,2017,69,180,249
2023-01-22,4,2023,1943,169,2112
2021-12-12,50,2021,1413,4,1417
2011-04-10,15,2011,244,149,393
2021-12-26,52,2021,6088,109,6197
2020-11-08,46,2020,13,5,18
2019-12-01,49,2019,1426,3461,4887
2017-11-05,45,2017,345,49,394
2021-05-16,20,2021,1,5,6
2009-10-11,42,2009,10840,18,10858
2008-05-11,20,2008,18,19,37
2014-05-18,21,2014,163,222,385
2002-02-17,8,2002,1339,86,1425
2008-07-20,30,2008,9,0,9
2014-06-22,26,2014,73,97,170
2021-01-10,2,2021,24,48,72
2019-03-24,13,2019,1613,196,1809
2014-10-12,42,2014,420,164,584
2018-12-09,50,2018,860,16,876
2012-05-13,20,2012,258,252,510
2004-07-18,29,2004,0,2,2
2021-04-18,16,2021,0,1,1
2017-02-05,6,2017,3069,413,3482
2005-05-22,21,2005,12,20,32
2019-09-29,40,2019,136,124,260
2016-03-06,10,2016,6679,2018,8697
2022-11-06,45,2022,1700,3,1703
2002-05-05,19,2002,2,86,88
2017-06-25,26,2017,45,32,77
2002-07-07,28,2002,0,0,0
2010-11-28,48,2010,348,261,609
2022-07-03,27,2022,593,30,623
2011-02-06,6,2011,3903,1183,5086
2003-06-01,23,2003,3,4,7
2002-06-09,24,2002,0,2,2
2011-11-06,45,2011,34,15,49
2012-11-04,45,2012,388,231,619
2018-06-17,25,2018,4,9,13
2021-04-11,15,2021,5,2,7
2017-01-29,5,2017,7779,1097,8876
2018-05-27,22,2018,76,89,165
2013-05-26,22,2013,56,92,148
2022-02-13,7,2022,2525,65,2590
2022-10-30,44,2022,1398,9,1407
2019-04-14,16,2019,1891,511,2402
2019-10-27,44,2019,221,556,777
2023-03-19,12,2023,109,49,158
2020-05-24,22,2020,3,1,4
2007-03-25,13,2007,554,211,765
2018-02-11,7,2018,11371,8210,19581
2006-02-19,8,2006,1129,130,1259
2013-01-06,2,2013,5752,1145,6897
2007-01-14,3,2007,638,80,718
2022-09-11,37,2022,503,37,540
2013-12-22,52,2013,4391,87,4478
2007-11-18,47,2007,127,13,140
2013-04-21,17,2013,140,239,379
2013-03-17,12,2013,325,894,1219
2016-05-15,20,2016,224,505,729
2009-06-07,24,2009,5407,15,5422
2015-08-09,32,2015,66,13,79
2014-11-09,46,2014,1269,147,1416
2021-08-29,35,2021,0,2,2
2021-11-07,45,2021,261,4,265
2016-08-28,35,2016,78,41,119
2021-04-25,17,2021,16,10,26
2017-08-27,35,2017,83,7,90
2006-04-30,18,2006,47,79,126
2013-02-10,7,2013,1353,1032,2385
2019-06-23,26,2019,93,96,189
2016-11-06,45,2016,271,121,392
2008-01-27,5,2008,3159,659,3818
2011-08-28,35,2011,13,1,14
2011-07-24,30,2011,2,1,3
2008-06-15,25,2008,5,2,7
2009-12-20,52,2009,389,3,392
2019-07-21,30,2019,104,85,189
2017-09-17,38,2017,137,75,212
2009-12-27,53,2009,420,8,428
2005-07-24,30,2005,1,1,2
2003-12-21,52,2003,2390,16,2406
2010-05-23,21,2010,6,2,8
2005-02-27,9,2005,1176,518,1694
2010-06-27,26,2010,6,1,7
2012-04-01,14,2012,1176,270,1446
2017-05-28,22,2017,171,314,485
2017-03-19,12,2017,3221,3715,6936
2020-10-18,43,2020,21,21,42
2015-05-17,20,2015,40,267,307
2014-01-26,5,2014,2555,153,2708
2005-10-30,44,2005,17,3,20
2020-07-12,29,2020,0,0,NA
2018-06-10,24,2018,9,13,22
2015-12-06,49,2015,78,24,102
2020-03-01,10,2020,1739,490,2229
2006-03-12,11,2006,818,322,1140
2022-11-06,45,2022,21338,188,21526
2014-10-26,44,2014,591,135,726
2018-08-12,33,2018,36,18,54
2004-08-08,32,2004,1,0,1
2015-03-15,11,2015,644,1564,2208
2003-11-09,46,2003,1302,2,1304
2020-11-29,49,2020,5,9,14
2009-08-09,33,2009,1713,5,1718
2020-10-25,44,2020,8,16,24
2003-12-07,50,2003,4057,29,4086
2023-03-12,11,2023,490,264,754
2018-05-06,19,2018,191,467,658
2014-11-30,49,2014,4705,242,4947
2007-04-08,15,2007,375,140,515
2014-02-02,6,2014,2091,198,2289
2014-07-20,30,2014,65,50,115
2012-12-02,49,2012,2754,678,3432
2019-11-03,45,2019,401,318,719
2021-07-11,28,2021,6,2,8
2016-05-29,22,2016,18,73,91
2012-12-23,52,2012,5283,1162,6445
2008-08-03,32,2008,6,1,7
2023-03-05,10,2023,133,31,164
2016-02-21,8,2016,4410,1276,5686
2008-12-14,51,2008,200,56,256
2008-04-13,16,2008,114,233,347
2019-09-29,40,2019,103,64,167
2023-03-26,13,2023,90,51,141
2008-11-02,45,2008,57,11,68
2018-09-09,37,2018,155,48,203
2017-02-19,8,2017,2463,605,3068
2004-03-21,12,2004,9,15,24
2020-11-08,46,2020,32,44,76
2008-03-23,13,2008,602,776,1378
2001-03-11,11,2001,27,148,175
2022-06-12,24,2022,353,3,356
2006-12-10,50,2006,421,120,541
2022-07-03,27,2022,97,1,98
2016-10-16,42,2016,148,19,167
2001-12-02,49,2001,110,2,112
2004-09-19,38,2004,3,1,4
2017-10-15,42,2017,187,14,201
2017-04-23,17,2017,326,946,1272
2010-02-07,6,2010,352,9,361
2013-09-22,39,2013,115,22,137
2019-12-08,50,2019,739,1133,1872
2002-09-08,37,2002,2,1,3
2007-11-11,46,2007,85,2,87
2016-12-25,52,2016,1739,109,1848
2016-11-27,48,2016,342,40,382
2013-12-29,1,2014,4898,84,4982
2007-05-20,21,2007,70,14,84
2004-07-04,27,2004,0,1,1
2010-04-18,16,2010,46,6,52
2008-09-07,37,2008,9,2,11
2020-06-28,27,2020,8,5,13
2021-10-24,43,2021,57,11,68
2018-07-08,28,2018,17,6,23
2009-02-08,7,2009,2250,945,3195
2022-04-17,16,2022,6303,52,6355
2001-02-04,6,2001,278,435,713
2010-11-14,46,2010,253,238,491
2021-09-26,39,2021,24,23,47
2004-08-15,33,2004,0,1,1
2017-02-26,9,2017,1559,609,2168
2011-07-03,27,2011,4,1,5
2018-02-25,9,2018,4405,4559,8964
2013-05-12,20,2013,54,120,174
2017-01-15,3,2017,6062,655,6717
2012-06-03,23,2012,104,200,304
2002-06-30,27,2002,0,1,1
2012-10-21,43,2012,200,139,339
2009-12-06,50,2009,799,3,802
2010-02-14,7,2010,374,6,380
2021-08-15,33,2021,5,1,6
2011-01-23,4,2011,3474,965,4439
2022-03-27,13,2022,5564,115,5679
2017-06-11,24,2017,131,162,293
2016-09-04,36,2016,57,56,113
2020-02-09,7,2020,2242,1034,3276
2002-01-20,4,2002,1450,24,1474
2014-11-16,47,2014,2239,163,2402
2016-01-10,2,2016,350,130,480
2017-01-01,1,2017,2133,126,2259
2018-11-04,45,2018,159,16,175
2008-03-09,11,2008,1461,1083,2544
2013-10-27,44,2013,233,41,274
2008-12-07,50,2008,146,37,183
2002-10-13,42,2002,4,1,5
2010-07-11,28,2010,8,2,10
2017-06-11,24,2017,52,65,117
2003-02-23,9,2003,522,245,767
2019-04-28,18,2019,634,332,966
2002-05-12,20,2002,3,61,64
2008-02-17,8,2008,3826,1360,5186
2015-10-25,43,2015,44,14,58
2019-12-15,51,2019,3697,8579,12276
2016-11-13,46,2016,347,144,491
2018-03-25,13,2018,360,624,984
2007-09-23,39,2007,20,0,20
2017-08-06,32,2017,49,27,76
2017-10-22,43,2017,230,35,265
2015-06-14,24,2015,74,78,152
2015-02-08,6,2015,3326,869,4195
2001-04-22,17,2001,1,8,9
2021-08-22,34,2021,6,3,9
2015-02-22,8,2015,1712,1127,2839
2015-01-11,2,2015,8172,473,8645
2014-07-06,28,2014,85,59,144
2020-01-05,2,2020,6109,7928,14037
2008-02-03,6,2008,3844,889,4733
2020-01-19,4,2020,1885,1401,3286
2004-02-01,5,2004,104,2,106
2016-02-21,8,2016,1932,754,2686
2021-05-30,22,2021,3,1,4
2014-04-20,17,2014,312,405,717
2021-01-03,1,2021,6,4,10
2022-09-04,36,2022,91,0,91
2007-03-04,10,2007,1119,470,1589
2002-06-23,26,2002,0,2,2
2020-02-23,9,2020,11713,4363,16076
2010-04-04,14,2010,127,0,127
2021-03-14,11,2021,5,2,7
2016-04-17,16,2016,419,407,826
2006-02-12,7,2006,971,94,1065
2001-02-18,8,2001,118,350,468
2001-04-29,18,2001,1,5,6
2020-09-13,38,2020,1,0,1
2018-08-05,32,2018,43,22,65
2010-12-05,49,2010,533,310,843
2018-05-20,21,2018,24,32,56
2019-04-14,16,2019,491,94,585
2004-01-04,1,2004,848,8,856
2006-11-19,47,2006,133,28,161
2006-04-02,14,2006,262,285,547
2018-02-11,7,2018,2030,1297,3327
2016-08-21,34,2016,63,25,88
2014-12-21,52,2014,13355,392,13747
2001-02-11,7,2001,199,413,612
2010-10-31,44,2010,141,106,247
2022-10-02,40,2022,297,8,305
2018-09-02,36,2018,34,2,36
2016-01-31,5,2016,856,303,1159
2022-03-13,11,2022,608,0,608
2013-11-03,45,2013,351,43,394
2021-10-03,40,2021,92,7,99
2002-10-27,44,2002,2,3,5
2023-01-01,1,2023,1462,14,1476
2005-06-26,26,2005,6,1,7
2014-03-23,13,2014,471,462,933
2010-04-11,15,2010,77,2,79
2018-04-22,17,2018,472,1074,1546
2018-05-27,22,2018,13,15,28
2015-05-03,18,2015,33,494,527
2018-11-11,46,2018,201,5,206
2018-07-01,27,2018,14,7,21
2004-10-31,44,2004,29,16,45
2016-12-04,49,2016,696,180,876
2020-11-15,47,2020,3,4,7
2010-01-31,5,2010,398,6,404
2010-01-24,4,2010,393,9,402
2009-01-25,5,2009,1573,380,1953
2002-12-01,49,2002,25,74,99
2010-06-13,24,2010,7,4,11
2008-05-04,19,2008,22,42,64
2019-02-10,7,2019,13313,509,13822
2016-02-07,6,2016,1144,438,1582
2021-11-21,47,2021,1285,39,1324
2006-01-15,3,2006,613,15,628
2014-10-05,41,2014,279,160,439
2016-06-26,26,2016,24,19,43
2015-08-23,34,2015,78,20,98
2020-12-13,51,2020,6,4,10
2001-01-21,4,2001,702,508,1210
2002-10-20,43,2002,3,3,6
2007-10-14,42,2007,46,2,48
2015-04-19,16,2015,89,683,772
2022-11-27,48,2022,3425,4,3429
2020-07-19,30,2020,5,4,9
2017-12-31,1,2018,3654,673,4327
2016-03-27,13,2016,2965,1514,4479
2022-02-13,7,2022,571,2,573
2018-07-29,31,2018,20,1,21
2019-06-23,26,2019,71,19,90
2003-05-25,22,2003,5,10,15
2022-06-26,26,2022,780,37,817
2016-06-26,26,2016,26,51,77
2018-03-04,10,2018,2897,3534,6431
2007-05-27,22,2007,21,9,30
2011-02-13,7,2011,4375,1368,5743
2008-12-21,52,2008,236,51,287
2022-01-09,2,2022,1028,2,1030
2003-05-11,20,2003,9,9,18
2020-04-12,16,2020,58,32,90
2021-10-10,41,2021,24,32,56
2008-10-26,44,2008,36,5,41
2017-11-12,46,2017,939,322,1261
2017-03-19,12,2017,878,840,1718
2016-02-28,9,2016,2231,701,2932
2019-06-16,25,2019,109,90,199
2009-05-17,21,2009,3782,93,3875
2021-11-14,46,2021,687,45,732
2011-12-04,49,2011,86,20,106
2019-07-21,30,2019,50,14,64
2017-02-05,6,2017,9702,1890,11592
2008-08-31,36,2008,6,0,6
2015-09-27,39,2015,73,32,105
2016-07-17,29,2016,24,26,50
2005-03-13,11,2005,635,466,1101
2016-09-25,39,2016,79,16,95
2009-01-11,3,2009,638,104,742
2020-05-24,22,2020,7,3,10
2007-10-07,41,2007,44,0,44
2005-10-02,40,2005,10,1,11
2001-11-25,48,2001,78,5,83
2012-01-01,1,2012,155,22,177
2014-10-19,43,2014,417,127,544
2012-02-05,6,2012,742,55,797
2017-09-17,38,2017,106,29,135
2022-08-21,34,2022,300,41,341
2021-06-27,26,2021,3,13,16
2008-03-30,14,2008,375,505,880
2023-01-08,2,2023,4852,156,5008
2018-09-16,38,2018,41,5,46
2003-03-16,12,2003,234,78,312
2011-03-20,12,2011,949,407,1356
2022-10-09,41,2022,453,8,461
2008-01-06,2,2008,850,161,1011
2020-12-20,52,2020,34,67,101
2001-12-23,52,2001,342,2,344
2012-10-07,41,2012,99,98,197
2022-09-25,39,2022,1268,83,1351
2021-05-23,21,2021,14,23,37
2004-03-28,13,2004,8,9,17
2018-02-25,9,2018,846,991,1837
2007-01-21,4,2007,1156,154,1310
2017-04-16,16,2017,567,1575,2142
2016-06-19,25,2016,27,30,57
2001-04-08,15,2001,3,42,45
2022-08-14,33,2022,223,34,257
2004-05-30,22,2004,2,4,6
2006-10-01,40,2006,41,15,56
2013-05-05,19,2013,75,174,249
2016-10-09,41,2016,108,83,191
2004-06-20,25,2004,2,1,3
2010-05-16,20,2010,16,3,19
2004-05-02,18,2004,3,6,9
2017-01-08,2,2017,4935,476,5411
2005-08-28,35,2005,3,1,4
2002-03-17,12,2002,174,284,458
2004-01-11,2,2004,498,5,503
2015-12-06,49,2015,140,106,246
2008-12-28,1,2009,307,50,357
2020-03-22,13,2020,115,56,171
2018-04-29,18,2018,73,174,247
2020-02-09,7,2020,13372,7180,20552
2018-04-15,16,2018,137,299,436
2010-12-26,52,2010,1720,655,2375
2004-12-26,52,2004,828,123,951
2007-03-11,11,2007,923,430,1353
2017-09-03,36,2017,128,68,196
2009-07-26,31,2009,2709,4,2713
2010-05-02,18,2010,30,1,31
2005-04-03,14,2005,142,210,352
2017-02-12,7,2017,9546,2552,12098
2003-05-04,19,2003,14,6,20
2004-04-04,14,2004,1,8,9
2017-02-26,9,2017,5605,2389,7994
2007-03-18,12,2007,721,369,1090
2018-12-23,52,2018,6849,240,7089
2020-08-30,36,2020,7,6,13
2008-06-08,24,2008,4,7,11
2007-12-30,1,2008,473,106,579
2016-08-14,33,2016,27,21,48
2012-07-15,29,2012,29,47,76
2018-01-14,3,2018,3183,772,3955
2022-09-04,36,2022,428,22,450
2005-03-27,13,2005,224,341,565
2018-04-15,16,2018,595,1424,2019
2019-08-25,35,2019,52,35,87
2005-06-19,25,2005,6,5,11
2005-01-23,4,2005,1557,306,1863
2019-01-20,4,2019,8309,243,8552
2017-10-15,42,2017,278,110,388
2020-09-20,39,2020,1,0,1
2017-06-04,23,2017,38,104,142
2021-03-07,10,2021,15,21,36
2019-12-08,50,2019,2158,5097,7255
2004-01-25,4,2004,163,3,166
2021-09-26,39,2021,4,2,6
2023-02-19,8,2023,725,219,944
2021-02-14,7,2021,19,22,41
2017-12-10,50,2017,1663,249,1912
2019-11-17,47,2019,509,606,1115
2019-05-19,21,2019,276,258,534
2018-01-07,2,2018,15149,3246,18395
2008-08-24,35,2008,2,3,5
2001-05-06,19,2001,0,9,9
2016-12-11,50,2016,1359,210,1569
2006-10-22,43,2006,61,23,84
2019-01-06,2,2019,1762,36,1798
2019-02-10,7,2019,3070,70,3140
2014-12-14,51,2014,11139,325,11464
2017-08-20,34,2017,80,37,117
2019-10-13,42,2019,142,93,235
2002-08-11,33,2002,0,0,0
2022-11-13,46,2022,28750,189,28939
2002-04-28,18,2002,5,140,145
2009-11-15,47,2009,3441,13,3454
2018-03-18,12,2018,2023,3103,5126
2022-08-21,34,2022,95,2,97
2007-12-23,52,2007,366,85,451
2011-06-19,25,2011,0,2,2
2018-07-01,27,2018,44,25,69
2016-10-02,40,2016,120,90,210
2013-10-13,42,2013,150,25,175
2015-03-22,12,2015,431,1479,1910
2015-10-25,43,2015,98,52,150
2011-01-30,5,2011,3785,1134,4919
2015-11-29,48,2015,145,81,226
2019-08-04,32,2019,40,17,57
2015-09-13,37,2015,134,33,167
2019-02-03,6,2019,13122,429,13551
2014-07-27,31,2014,73,21,94
2009-08-16,34,2009,2102,1,2103
2017-07-23,30,2017,42,25,67
2002-01-13,3,2002,1231,12,1243
2009-05-03,19,2009,4431,490,4921
2023-05-07,19,2023,171,295,466
2019-12-22,52,2019,1325,1698,3023
2018-12-30,1,2019,5238,152,5390
2021-06-20,25,2021,1,0,1
2015-07-05,27,2015,63,36,99
2023-01-08,2,2023,855,14,869
2017-10-29,44,2017,503,219,722
2019-07-28,31,2019,104,85,189
2001-04-01,14,2001,8,37,45
2023-02-12,7,2023,172,29,201
2002-09-15,38,2002,0,2,2
2022-12-04,49,2022,3156,6,3162
2013-06-30,27,2013,44,23,67
2007-09-09,37,2007,23,7,30
2021-10-17,42,2021,26,39,65
2009-02-22,9,2009,1768,1147,2915
2010-01-03,1,2010,358,8,366
2023-05-28,22,2023,20,14,34
2022-09-25,39,2022,155,4,159
2021-09-12,37,2021,9,14,23
2017-06-18,25,2017,45,50,95
2016-03-13,11,2016,1751,617,2368
2017-12-03,49,2017,2479,827,3306
2014-08-31,36,2014,82,29,111
2017-03-05,10,2017,1321,634,1955
2019-09-08,37,2019,95,48,143
2019-06-30,27,2019,73,17,90
2019-09-22,39,2019,153,322,475
2002-03-24,13,2002,95,235,330
2021-05-30,22,2021,7,15,22
2008-04-06,15,2008,198,410,608
